1111111111111
1001000000C01
1000011111001
1C00111000E01
100000C100001
1P00000000001
1111111111111