111111111
10C0PCE01
10C000001
10C000001
10C000001
10C000001
10C000001
10C000001
10C000001
10C000001
10C000001
10C000001
10C000001
10C000001
10C000001
10C000001
10C000001
10C000001
10C000001
10C000001
10C000001
10C000001
10C000001
10C000001
10C000001
10C000001
10C000001
10C000001
10C000001
10C000001
10C000001
10C000001
10C000001
10C000001
10C000001
10C000001
10C000001
10C000001
10C000001
10C000001
10C000001
10C000001
10C000001
10C000001
10C000001
10C000001
10C000001
10C000001
10C000001
10C000001
10C000001
10C000001
10C000001
10C000001
10C000001
10C000001
10C000001
10C000001
10C000001
10C000001
10C000001
10C000001
10C000001
10C000001
10C000001
10C000001
10C000001
10C000001
10C000001
10C000001
10C000001
10C000001
10C000001
10C000001
10C000001
10C000001
10C000001
10C000001
10C000001
10C000001
10C000001
10C000001
10C000001
10C000001
10C000001
10C000001
10C000001
10C000001
10C000001
10C000001
10C000001
10C000001
10C000001
10C000001
10C000001
10C000001
10C000001
10C000001
10C000001
10C000001
10C000001
10C000001
10C000001
10C000001
10C000001
10C000001
10C000001
10C000001
10C000001
10C000001
10C000001
10C000001
10C000001
10C000001
10C000001
10C000001
10C000001
10C000001
10C000001
10C000001
10C000001
10C000001
10C000001
10C000001
10C000001
10C000001
10C000001
10C000001
10C000001
10C000001
10C000001
10C000001
10C000001
10C000001
10C000001
10C000001
10C000001
10C000001
10C000001
10C000001
10C000001
10C000001
10C000001
10C000001
10C000001
10C000001
10C000001
10C000001
10C000001
10C000001
10C000001
10C000001
10C000001
10C000001
10C000001
10C000001
10C000001
10C000001
10C000001
10C000001
10C000001
10C000001
10C000001
10C000001
10C000001
10C000001
10C000001
10C000001
10C000001
10C000001
10C000001
10C000001
10C000001
10C000001
10C000001
10C000001
10C000001
10C000001
10C000001
10C000001
10C000001
10C000001
10C000001
10C000001
10C000001
10C000001
111111111