111111111111111111111111111111111111111111111111111
111111C10000100000000000C00000000111110101101100001
10000000011111110001E100010001111100000111110011011
1C000010111110000C000000000000001110000100101010011
1000001001010000000010000001011110000000CC000001011
11111110000C100000001000000001000001000001110010111
100000C000010101C0C1100010C00000000000111C000000001
1C1000000000000000011110011100000000000000000011011
11100000P1C0000011110000001100000000010000000000001
1000C01111000000CC000000000000111110000001100000001
111111111111111111111111111111111111111111111111111