1111111111
10000C0P01
1101111C11
1E0101C001
1111111111
