1111111111111
1C000P00C0E01
1111111111111
