111111111
1P0000001
111111101
1CE0000C1
111111111
